# ########
#    #   #
#### # # #
#    #   #
# ## ### #
#    #s# #
# #### # #
#    # # #
####     #
##########